1111111111111111111
1222222221222222221
1311211121211121131
1222222222222222221
1211212111112121121
1222212221222122221
1111211101011121111
111121000H000121111
111121011I110121111
22222001BNC10022222
1111210111110121111
1111210000000121111
1111210111110121111
1222222221222222221
1211211121211121121
122122222P222221221
1121212111112121211
1222212221222122221
1311111121211111131
1222222222222222221
1111111111111111111