11111111111111111111
12322211111122212321
12121211111121222121
12121211111121112121
12222222222222222121
12121111101121211121
12122210000021222121
12121210111121212121
122212001C1122212221
1112111HIN1111P11121
122212001B1122212221
12121210111121212121
12122210000021222121
12121111101121211121
12222222222222222121
12121211111121112121
12121211111121222121
12322211111122212321
11111111111111111111